10
10
$$$$$$$$$$
$        $
$        $
$##      $
$X       $
$        $
$        $
$     E# $
$        $
$$$$$$$$$$
2
3,3,5,7
5,7,3,3
3
1,1
2,3
2,2

