10
10
#####$####
#           ###  
#           ##
###        #### 
#X         #      ##  
#           # # # 
#           # # # # 
#      E# 
#         
##########
1
2,0,3,3
3
1,1
2,3
2,2

