10
10
##########
#           ###  
#           ##
###        #### 
#X         #      ##  
#           # # # 
#           # # # # 
#      E# 
#         
##########
5,7,3,3